"aa" = (/turf/space,/area/space)
"ab" = (/turf/simulated/wall,/area/constructionsite)
"ac" = (/turf/simulated/floor/tiled,/area/constructionsite)
"ad" = (/obj/machinery/light{dir = 1},/turf/simulated/floor/tiled,/area/constructionsite)
"ae" = (/obj/effect/landmark{name = "tdome1"},/turf/simulated/floor/tiled,/area/constructionsite)
"af" = (/obj/effect/floor_decal/industrial/hatch/yellow,/turf/simulated/floor/tiled,/area/constructionsite)
"ag" = (/obj/machinery/light_switch{pixel_x = 25},/turf/simulated/floor/tiled,/area/constructionsite)
"ah" = (/obj/machinery/light{icon_state = "tube1"; dir = 8},/turf/simulated/floor/tiled,/area/constructionsite)
"ai" = (/obj/structure/ladder/up,/turf/simulated/floor/tiled,/area/constructionsite)
"aj" = (/obj/machinery/light{icon_state = "tube1"; dir = 4},/turf/simulated/floor/tiled,/area/constructionsite)
"ak" = (/obj/machinery/atmospherics/unary/vent_pump/on,/turf/simulated/floor/tiled,/area/constructionsite)
"al" = (/turf/simulated/wall/iron,/area/shuttle/escape)
"am" = (/obj/machinery/atmospherics/pipe/simple/visible{tag = "icon-intact (NORTHEAST)"; icon_state = "intact"; dir = 5},/turf/simulated/floor/tiled,/area/constructionsite)
"an" = (/obj/machinery/atmospherics/pipe/simple/visible{tag = "icon-intact (EAST)"; icon_state = "intact"; dir = 4},/turf/simulated/floor/tiled,/area/constructionsite)
"ao" = (/obj/machinery/atmospherics/portables_connector{tag = "icon-map_connector (WEST)"; icon_state = "map_connector"; dir = 8},/obj/machinery/portable_atmospherics/canister/air,/turf/simulated/floor/tiled,/area/constructionsite)
"ap" = (/obj/effect/wingrille_spawn/reinforced,/turf/simulated/floor/plating,/area/shuttle/escape)
"aq" = (/obj/machinery/computer/shuttle_control{shuttle_tag = "Example"},/turf/simulated/floor/plating,/area/shuttle/escape)
"ar" = (/obj/machinery/light_switch{pixel_x = -25},/turf/simulated/floor/tiled,/area/constructionsite)
"as" = (/obj/effect/landmark/start,/turf/simulated/floor/tiled,/area/constructionsite)
"at" = (/obj/structure/bed/chair{dir = 1},/obj/machinery/embedded_controller/radio/simple_docking_controller{id_tag = "example_shuttle_starboard"; pixel_x = 28},/obj/machinery/embedded_controller/radio/simple_docking_controller{id_tag = "example_shuttle_port"; pixel_x = -28},/turf/simulated/floor/plating,/area/shuttle/escape)
"au" = (/obj/item/stack/material/uranium/ten,/turf/simulated/floor/tiled,/area/constructionsite)
"av" = (/obj/item/stack/material/platinum,/obj/item/stack/material/platinum,/obj/item/stack/material/platinum,/obj/item/stack/material/platinum,/obj/item/stack/material/platinum,/turf/simulated/floor/tiled,/area/constructionsite)
"aw" = (/obj/effect/landmark/test/safe_turf,/turf/simulated/floor/tiled,/area/constructionsite)
"ax" = (/obj/machinery/atmospherics/pipe/simple/visible{tag = "icon-intact (SOUTHEAST)"; icon_state = "intact"; dir = 6},/turf/simulated/floor/tiled,/area/constructionsite)
"ay" = (/obj/machinery/atmospherics/portables_connector{tag = "icon-map_connector (WEST)"; icon_state = "map_connector"; dir = 8},/obj/machinery/portable_atmospherics/canister/empty,/turf/simulated/floor/tiled,/area/constructionsite)
"az" = (/obj/machinery/door/airlock/external/bolted{frequency = 1379; id_tag = "example_shuttle_port_hatch"},/turf/simulated/floor/plating,/area/shuttle/escape)
"aA" = (/obj/machinery/light,/turf/simulated/floor/plating,/area/shuttle/escape)
"aB" = (/obj/machinery/door/airlock/external/bolted{frequency = 1379; id_tag = "example_shuttle_starboard_hatch"},/turf/simulated/floor/plating,/area/shuttle/escape)
"aC" = (/obj/machinery/door/airlock/external/bolted{frequency = 1379; id_tag = "lower_level_dock_hatch"},/turf/simulated/floor,/area/constructionsite)
"aD" = (/obj/machinery/embedded_controller/radio/simple_docking_controller{id_tag = "lower_level_dock"; pixel_x = -8; pixel_y = -25},/turf/simulated/floor,/area/constructionsite)
"aE" = (/turf/simulated/floor,/area/constructionsite)
"aF" = (/obj/item/stack/material/plasteel/fifty,/turf/simulated/floor/tiled,/area/constructionsite)
"aG" = (/obj/item/stack/material/plastic/fifty,/turf/simulated/floor/tiled,/area/constructionsite)
"aH" = (/obj/machinery/light{icon_state = "tube1"; dir = 8},/obj/item/stack/material/diamond/ten,/turf/simulated/floor/tiled,/area/constructionsite)
"aI" = (/obj/item/stack/material/gold/ten,/turf/simulated/floor/tiled,/area/constructionsite)
"aJ" = (/obj/effect/landmark{name = "JoinLate"},/turf/simulated/floor/tiled,/area/constructionsite)
"aK" = (/obj/structure/closet/crate/freezer,/obj/item/device/mmi,/obj/item/device/mmi,/obj/item/device/mmi,/obj/machinery/camera/network/engineering{c_tag = "Engineering - Robotics Surgical Theater"; dir = 4},/obj/item/device/radio/intercom{pixel_y = 22},/turf/simulated/floor/tiled/white,/area/constructionsite)
"aL" = (/obj/structure/closet/secure_closet/medical2,/turf/simulated/floor/tiled/white,/area/constructionsite)
"aM" = (/obj/structure/table/standard,/obj/machinery/atmospherics/unary/vent_pump/on,/obj/machinery/alarm{frequency = 1439; pixel_y = 23; req_one_access = list(201)},/obj/item/weapon/storage/firstaid/surgery,/turf/simulated/floor/tiled/white,/area/constructionsite)
"aN" = (/obj/machinery/optable{name = "Robotics Operating Table"},/obj/machinery/vending/wallmed1{pixel_y = 32},/turf/simulated/floor/tiled/white,/area/constructionsite)
"aO" = (/obj/machinery/computer/operating{name = "Robotics Operating Computer"},/turf/simulated/floor/tiled/white,/area/constructionsite)
"aP" = (/obj/structure/cable{d2 = 2; icon_state = "0-2"; pixel_y = 0},/obj/machinery/power/apc{dir = 8; name = "west bump"; pixel_x = -24},/obj/item/stack/material/glass/fifty,/obj/item/stack/material/glass/fifty,/obj/item/stack/material/glass/fifty,/turf/simulated/floor/tiled,/area/constructionsite)
"aQ" = (/obj/item/stack/material/steel/fifty,/obj/item/stack/material/steel/fifty,/obj/item/stack/material/steel/fifty,/obj/item/stack/material/steel/fifty,/turf/simulated/floor/tiled,/area/constructionsite)
"aR" = (/obj/machinery/atmospherics/pipe/simple/hidden/supply{dir = 6},/obj/machinery/atmospherics/pipe/simple/hidden/scrubbers{dir = 6},/obj/machinery/firealarm{dir = 8; pixel_x = -24},/obj/structure/sink{icon_state = "sink"; dir = 8; pixel_x = -12; pixel_y = 2},/turf/simulated/floor/tiled/white,/area/constructionsite)
"aS" = (/obj/machinery/atmospherics/pipe/simple/hidden/supply{dir = 4},/obj/machinery/atmospherics/pipe/simple/hidden/scrubbers{dir = 4},/turf/simulated/floor/tiled/white,/area/constructionsite)
"aT" = (/obj/machinery/atmospherics/pipe/manifold/hidden/supply,/obj/machinery/atmospherics/pipe/simple/hidden/scrubbers{dir = 4},/turf/simulated/floor/tiled/white,/area/constructionsite)
"aU" = (/obj/machinery/atmospherics/pipe/manifold/hidden/scrubbers{dir = 1},/obj/machinery/atmospherics/pipe/simple/hidden/supply{dir = 4},/turf/simulated/floor/tiled/white,/area/constructionsite)
"aV" = (/obj/machinery/atmospherics/pipe/simple/hidden/supply{dir = 4},/obj/machinery/atmospherics/pipe/simple/hidden/scrubbers{dir = 4},/obj/machinery/door/firedoor,/turf/simulated/floor/tiled/white,/area/constructionsite)
"aW" = (/obj/structure/cable{d1 = 1; d2 = 2; icon_state = "1-2"; pixel_y = 0},/turf/simulated/floor/tiled,/area/constructionsite)
"aX" = (/obj/machinery/mecha_part_fabricator,/turf/simulated/floor/tiled,/area/constructionsite)
"aY" = (/obj/machinery/atmospherics/pipe/simple/hidden/supply{dir = 9; pixel_y = 0},/obj/machinery/atmospherics/pipe/simple/hidden/scrubbers{dir = 9},/obj/item/weapon/reagent_containers/food/snacks/meat,/obj/item/weapon/reagent_containers/food/snacks/meat,/obj/item/weapon/reagent_containers/food/snacks/meat,/obj/item/weapon/reagent_containers/food/snacks/meat,/obj/item/weapon/reagent_containers/food/snacks/meat,/obj/item/weapon/reagent_containers/food/snacks/meat,/turf/simulated/floor/tiled/white,/area/constructionsite)
"aZ" = (/obj/machinery/hologram/holopad,/turf/simulated/floor/tiled/white,/area/constructionsite)
"ba" = (/obj/effect/landmark{name = "lightsout"},/turf/simulated/floor/tiled/white,/area/constructionsite)
"bb" = (/obj/machinery/atmospherics/pipe/simple/hidden/scrubbers,/turf/simulated/floor/tiled/white,/area/constructionsite)
"bc" = (/obj/structure/table/standard,/obj/item/weapon/reagent_containers/spray/sterilizine,/turf/simulated/floor/tiled/white,/area/constructionsite)
"bd" = (/obj/structure/cable,/obj/machinery/power/debug_items/infinite_generator,/turf/simulated/floor/tiled,/area/constructionsite)
"be" = (/obj/machinery/light,/turf/simulated/floor/tiled,/area/constructionsite)
"bf" = (/obj/structure/closet/secure_closet/freezer/meat,/turf/simulated/floor/tiled,/area/constructionsite)
"bg" = (/obj/effect/wingrille_spawn/reinforced,/turf/simulated/floor/plating,/area/constructionsite)
"bh" = (/obj/machinery/organ_printer/flesh/mapped,/obj/machinery/light,/turf/simulated/floor/tiled/white,/area/constructionsite)
"bi" = (/obj/machinery/organ_printer/robot/mapped,/turf/simulated/floor/tiled/white,/area/constructionsite)
"bj" = (/obj/structure/table/standard,/obj/item/weapon/storage/box/bodybags,/turf/simulated/floor/tiled/white,/area/constructionsite)
"bk" = (/obj/structure/table/standard,/obj/machinery/atmospherics/unary/vent_scrubber/on{dir = 1},/obj/item/device/robotanalyzer,/obj/item/weapon/storage/box/syringes,/turf/simulated/floor/tiled/white,/area/constructionsite)
"bl" = (/obj/structure/table/standard,/obj/machinery/light,/obj/item/stack/nanopaste,/turf/simulated/floor/tiled/white,/area/constructionsite)
"bm" = (/obj/effect/landmark/test/space_turf,/turf/space,/area/space)

(1,1,1) = {"
aaaaaaaaaaaaaaaaaaaaaaaaaaaaaaaaaaaaaaaaaaaaaaaaaaaaaaaaaaaaaaaaaaaaaaaaaaaaaaaaaaaaaaaaaaaaaaaa
aaaaaaaaaaaaaaaaaaaaaaaaaaaaaaaaaaaaaaaaaaaaaaaaaaaaaaaaaaaaaaaaaaaaaaaaaaaaaaaaaaaaaaaaaaaaaaaa
aaaaaaaaaaaaaaaaaaaaaaaaaaaaaaaaaaaaaaaaaaaaaaaaaaaaaaaaaaaaaaaaaaaaaaaaaaaaaaaaaaaaaaaaaaaaaaaa
aaaaaaaaaaaaaaaaaaaaaaaaaaaaaaaaaaaaaaaaaaaaaaaaaaaaaaaaaaaaaaaaaaaaaaaaaaaaaaaaaaaaaaaaaaaaaaaa
aaaaaaaaaaaaaaaaaaaaaaaaaaaaaaaaaaaaaaaaaaaaaaaaaaaaaaaaaaaaaaaaaaaaaaaaaaaaaaaaaaaaaaaaaaaaaaaa
aaaaaaaaaaaaaaaaaaaaaaaaaaaaaaaaaaaaaaaaaaaaaaaaaaaaaaaaaaaaaaaaaaaaaaaaaaaaaaaaaaaaaaaaaaaaaaaa
aaaaaaaaaaaaaaaaaaaaaaaaaaaaaaaaaaaaaaaaaaaaaaaaaaaaaaaaaaaaaaaaaaaaaaaaaaaaaaaaaaaaaaaaaaaaaaaa
aaaaaaaaaaaaaaaaaaaaaaaaaaaaaaaaaaaaaaaaaaaaaaaaaaaaaaaaaaaaaaaaaaaaaaaaaaaaaaaaaaaaaaaaaaaaaaaa
aaaaaaaaaaaaaaaaaaaaaaaaaaaaaaaaaaaaaaaaaaaaaaaaaaaaaaaaaaaaaaaaaaaaaaaaaaaaaaaaaaaaaaaaaaaaaaaa
aaaaaaaaaaaaaaaaaaaaaaaaaaaaaaaaaaabababababababababababababababaaaaaaaaaaaaaaaaaaaaaaaaaaaaaaaa
aaaaaaaaaaaaaaaaaaaaaaaaaaaaaaaaaaabacacacadacacacacacadacacacabaaaaaaaaaaaaaaaaaaaaaaaaaaaaaaaa
aaaaaaaaaaaaaaaaaaaaaaaaaaaaaaaaaaabacaeaeaeacafabafacacacacacabaaaaaaaaaaaaaaaaaaaaaaaaaaaaaaaa
aaaaaaaaaaaaaaaaaaaaaaaaaaaaaaaaaaabacaeaeaeacafafafacacacacagabaaaaaaaaaaaaaaaaaaaaaaaaaaaaaaaa
aaaaaaaaaaaaaaaaaaaaaaaaaaaaaaaaaaabahaeaeaeaiafafafacacacacajabaaaaaaaaaaaaaaaaaaaaaaaaaaaaaaaa
aaaaaaaaaaaaaaaaaaaaaaaaaaaaaaaaaaabacacacacacacacacacacakacacabaaaaaaaaaaaaaaaaaaaaaaaaaaaaaaaa
aaaaaaaaaaaaaaaaaaaaaaaaalalalaaaaabacacacacacacacacacacamanaoabaaaaaaaaaaaaaaaaaaaaaaaaaaaaaaaa
aaaaaaaaaaaaaaaaaaaaaaaaapaqapaaaaabaracacacacacasacacacacacacabaaaaaaaaaaaaaaaaaaaaaaaaaaaaaaaa
aaaaaaaaaaaaaaaaaaaaaaaaapatapabababauavacacawacacacacacaxanayabaaaaaaaaaaaaaaaaaaaaaaaaaaaaaaaa
aaaaaaaaaaaaaaaaaaaaaaaaazaAaBaCaDaEaFaGacacacabababababababacabaaaaaaaaaaaaaaaaaaaaaaaaaaaaaaaa
aaaaaaaaaaaaaaaaaaaaaaaaalalalabababaHaIaJaJaJabaKaLaMaNaOabajabaaaaaaaaaaaaaaaaaaaaaaaaaaaaaaaa
aaaaaaaaaaaaaaaaaaaaaaaaaaaaaaaaaaabaPaQaJaJaJabaRaSaTaUaSaVacabaaaaaaaaaaaaaaaaaaaaaaaaaaaaaaaa
aaaaaaaaaaaaaaaaaaaaaaaaaaaaaaaaaaabaWaXaJaJaJaSaYaZbabbbcabacabaaaaaaaaaaaaaaaaaaaaaaaaaaaaaaaa
aaaaaaaaaaaaaaaaaaaaaaaaaaaaaaaaaaabbdacacbebfbgbhbibjbkblabacabaaaaaaaaaaaaaaaaaaaaaaaaaaaaaaaa
aaaaaaaaaaaaaaaaaaaaaaaaaaaaaaaaaaabababababababababababababababaaaaaaaaaaaaaaaaaaaaaaaaaaaaaaaa
aaaaaaaaaaaaaaaaaaaaaaaaaaaaaaaaaaaaaaaaaaaaaaaaaaaaaaaaaaaaaaaaaaaaaaaaaaaaaaaaaaaaaaaaaaaaaaaa
aaaaaaaaaaaaaaaaaaaaaaaaaaaaaaaaaaaaaaaaaaaaaaaaaaaaaaaaaaaaaaaaaaaaaaaaaaaaaaaaaaaaaaaaaaaaaaaa
aaaaaaaaaaaaaaaaaaaaaaaaaaaaaaaaaaaaaaaaaaaabmaaaaaaaaaaaaaaaaaaaaaaaaaaaaaaaaaaaaaaaaaaaaaaaaaa
aaaaaaaaaaaaaaaaaaaaaaaaaaaaaaaaaaaaaaaaaaaaaaaaaaaaaaaaaaaaaaaaaaaaaaaaaaaaaaaaaaaaaaaaaaaaaaaa
aaaaaaaaaaaaaaaaaaaaaaaaaaaaaaaaaaaaaaaaaaaaaaaaaaaaaaaaaaaaaaaaaaaaaaaaaaaaaaaaaaaaaaaaaaaaaaaa
aaaaaaaaaaaaaaaaaaaaaaaaaaaaaaaaaaaaaaaaaaaaaaaaaaaaaaaaaaaaaaaaaaaaaaaaaaaaaaaaaaaaaaaaaaaaaaaa
aaaaaaaaaaaaaaaaaaaaaaaaaaaaaaaaaaaaaaaaaaaaaaaaaaaaaaaaaaaaaaaaaaaaaaaaaaaaaaaaaaaaaaaaaaaaaaaa
aaaaaaaaaaaaaaaaaaaaaaaaaaaaaaaaaaaaaaaaaaaaaaaaaaaaaaaaaaaaaaaaaaaaaaaaaaaaaaaaaaaaaaaaaaaaaaaa
"}
